10 12 2 2 2 3
.__________.
.__________.
+__________x
.__________.
.__________.
.__________.
.__________.
+__________+
.__________.
.__________.
2 0
7 0
2 11
7 11
110100101001
001100110111
BBWPWWPGWGGP
001011110101
101011101011
GGPWPPPBWBWP
001011010111
010110111000
WGWGPBWPGWBB
