10 12 2 1 2 3
.__________.
.__________.
x___________
.__________.
.__________.
.__________.
.__________.
____________
.__________.
.__________.
2 0
2 11
7 11
01011100
BGBGBBBG
11001010
BBBGGBGB
10101110
BBGBGBBB
