10 14 2 1 2
..__________..
..__________..
x<__________>_
..__________..
..__________..
..__________..
..__________..
.<__________>_
..__________..
..__________..
2 0
2 13
7 13
11001011010100101010101010110
BBBGGGBBBBGBGGGGBGBGBGBGBGBBB
