5 8 1 1 2
..____..
x<____>_
..____..
..____>_
..____..
1 0
1 7
3 7
10
CC
