10 12 2 1 2 2
.__________.
.__________.
x___________
.__________.
.__________.
.__________.
.__________.
.___________
.__________.
.__________.
2 0
2 11
7 11
10010101
GBBGBGBG
10110100
GBGGBGBB
