10 12 2 0 2 1
.__________.
.__________.
.__________x
.__________.
.__________.
.__________.
.__________.
.__________+
.__________.
.__________.
2 11
7 11
ROYGBPROYGBPROYGBP
