10 12 2 2 1 3
.__________.
.__________.
x__________x
.__________.
.__________.
.__________.
.__________.
+__________.
.__________.
.__________.
2 0
7 0
2 11
101010111001
100101110110
BBGBBGGBBBGB
101110101011
111101011101
BBGBBBBGGBBG
001010011101
001110101011
BGBBGGBGGBBG
