10 12 2 2 2 2
.__________.
.__________.
x___________
.__________.
.__________.
.__________.
.__________.
x___________
.__________.
.__________.
2 0
7 0
2 11
7 11
100100101010
010010011101
BBGBBGBBGGBB
010110010110
000110101101
GBGGBGGBBGBB
