10 12 2 2 1 3
.__________.
.__________.
x__________x
.__________.
.__________.
.__________.
.__________.
x__________.
.__________.
.__________.
2 0
7 0
2 11
100100101010
010010011101
BBGBBGBBGGBB
010110010110
000110101101
GBGGBGGBBGBB
100110111010
010010110011
BBGBBGGGBGGB
