10 12 2 1 2 3
.__________.
.__________.
x__________x
.__________.
.__________.
.__________.
.__________.
.__________+
.__________.
.__________.
2 0
2 11
7 11
01010101
BRRBBRRB
10110110
RRBRRBRR
00110101
BBRBBRRB
