10 12 2 1 2 3
.__________.
.__________.
x__________x
.__________.
.__________.
.__________.
.__________.
.__________+
.__________.
.__________.
2 0
2 11
7 11
111011000011
BORBORBGRRBO
011001110010
RBOBGBORBGBG
011101101000
RBORBORBOBGR
